NO textures/wall_1.xpm

1111111
1N00001
1010001
1111111
