NO ./textures/redbrick.xpm
SO ./textures/wood.xpm
WE ./textures/greystone.xpm
EA ./textures/bluestone.xpm

F 105,105,105
C 0,255,255

        1111111111111111111111111
        1000000000110000000000001
        1011000001110000000000001
        1001000000000000000000001
111111111011000001110000000000001
100000000011000001110111100111111
11110111111111011100000010001
11110111111111011101111010001
110000001101010111001 1010001
10000000000000001100111010001
1000000000E000001101010010001
1100000111010101111101111000111
11110111 1110101 101111010001
11111111 1111111 111111111111